0001111111003
0102111112011
1101110000011
1101114211111
1100000111111