5
13
0001110000003
0102110111111
1101110000021
1102111112011
1100000000011